GGGGGGGGGGGGGGGGGGGGGGGG
GGGGG/------------------
GGGG/-------------------
GGG/--------------------
------------------------
-________________GGGGGG-
------------------\GGGG-
-------------------\GGG-
--------------------\GG-
------------------------
-GGGGGG________________-
-GGGG/------------------
-GGG/-------------------
-GG/--------------------
------------------------
-_________________GGGGG-
------------------------
------------------------