GGGGGGGG------GGGGGGGGGGGGGGGGGGGGGGGGGGGGGGGGGGGG
-------\G---------G/------------------------------
--------\G--------------__------------G-----G-----
---------\G---GGG---------GGGGGGGGGG--------------
---GGG----\G---G/---------------------------------
-----------\G-G/---------------_----_-------------
------------\G/----------------------GGGGG--------
------------------------------G-------------------
---------------------------------------------GGG--
-------------------------GGGGG--------------------
--------------------------------------------------
---------------------------------G----------------
-------------------------------------GGG----------
--------------------------------------------------
--------------------------------------------------